6 6
0 1 0 1 0 1
0 0 0 0 0 0
1 1 0 1 0 1
0 0 0 0 0 0
1 0 1 0 1 1
0 0 0 0 0 0

使用：
    矩阵长度 矩阵宽度
    [矩阵（通路用0,阻碍用1）]